111111111111111
1N0E000V0000C01
100C0C0C0V00011
11V1110H0011111
100C0C0C0V00011
11V1110H0011111
100C0C0C0V00011
11V1110H0011111
100C0C0C0V00011
11V1110H0011111
100C0C0C0V00011
11V1110H0011111
100C0C0C0V00011
11V1110H0011111
100C0C0C0V00011
11V1110H0011111
100C0C0C0V00P11
11V1110H0011111
111111111111111
