111111111111111
1000EE00C000C01
100C0C0CC000011
110111000011111
100C0C0CC000011
11011100P011111
100C0C0C0000011
110111000011111
100C0C0C0000011
110111000011111
100C0C0C0000011
110111000011111
100C0C0C0000011
110111000011111
100C0C0C0000011
110111000011111
100C0C0C0000011
110111000011111
111111111111111
