111111111111111
1000EE00C000E01
100E0E0EE000011
110111000011111
100E0E0EE000011
11011100P011111
100E0E0E0000011
110111000011111
100E0E0E0000011
110111000011111
100E0E0E0000011
110111000011111
100E0E0E0000011
110111000011111
100E0E0E0000011
110111000011111
100E0E0E0000011
110111000011111
111111111111111
