111111111111111
1000P0E000C0001
111111111111111