1111111111111111111111111111111
111SSSSSSSS0SSSSSSS1SCSSSSSSSS1
111E1111111111111101111111111S1
1P00SSSSSSSSSSSSSSSSSSSSSSSSSC1
1111111111111111111111111111111
1111111111111111111111111111111
