111111111111111
100000000000001
1000P0E000C0001
100000000000001
111111111111111
