1111111111
10S0000001
1000P0E001
10C0000001
1111111111
