11111111111111111111111111111111111
10000000000000000000000000000000001
10000000000000000000000000000000001
10000110000110001111000110001100001
10000011001100110000110110001100001
10000000110000110000110110001100001
10000000110000001111000001110000001
10000000000000000000000000000000001
10000000000000000000000000000000001
10011000110110001101101100001100001
10001100011000011001101111001100001
10000110110110110001101101101100001
10000001000001000001101100111100001
10000000000000000000000000000000001
10000000000000000000000000000000001
11111111111111111111111111111111111